alias all='gpssh -f /home/gpadmin/gpconfigs/hostfile_all'
alias seg='gpssh  -f /home/gpadmin/gpconfigs/hostfile_seg'

## gpdb 4/5
alias cq='psql -c "select now()-query_start, procpid, usename, sess_id, current_query from pg_stat_activity where current_query not like '\''%IDLE%'\'' order by 1 desc;"'
alias dq='psql -c "select now()-query_start as run_time, rsqname,usename, client_addr, waiting, procpid, sess_id from pg_stat_activity, pg_roles, pg_resqueue where pg_stat_activity.usename = pg_roles.rolname and pg_roles.rolresqueue = pg_resqueue.oid and current_query not like '\''%IDLE%'\'' order by 5,1 ;"'
alias invalid='psql -c "SELECT * from gp_configuration where valid='\''f'\'';"'
alias is='psql -c " SELECT now()-query_start, usename, procpid, sess_id, current_query from pg_stat_activity where current_query like '\''<IDLE>'\'' order by 1 desc;"'
alias it='psql  -c "SELECT now()-query_start, usename, procpid, sess_id, current_query FROM dbm.pg_stat_activity() where trim(current_query) like '\''%in transaction'\'' ORDER BY 1 DESC;"'
alias locks='psql -c " SELECT pid, relname, locktype, mode from pg_locks, pg_class where relation=oid and relname not like '\''pg_%'\'' order by 3;"'
alias na='psql -c "SELECT count(relname) from pg_class where reltuples=0 and relpages=0 and relkind='\''r'\'' and relname not like '\''t%'\'' and relname not like '\''err%'\'';" '
alias nan='psql -c "SELECT '\''analyze '\''||nspname||'\''.'\''||relname||'\'';'\'' from pg_class c, pg_namespace nc where nc.oid = c.relnamespace and c.reltuples=0 and c.relpages=0 and c.relkind='\''r'\'' and c.relname not like '\''t%'\'' and c.relname not like '\''err%'\'';"'
alias pgoption='PGOPTIONS="-c gp_session_role=utility" psql -p 5432'
alias qq='psql -c " select now()-query_start, usename, client_addr, waiting, procpid, sess_id from pg_stat_activity  where current_query not like '\''%IDLE%'\'' order by 4, 1 desc;"'
alias ra='psql -c " select * from admin.queuerole1;"'
alias rq='psql -c " select count(*) from pg_stat_activity where current_query not like '\''%IDLE%'\'' and waiting='\''f'\'';"'
alias rss='psql -c " select a.rsqname, a.rsqcountlimit as countlimit, a.rsqcountvalue as countvalue, a.rsqwaiters as waiters, a.rsqholders as running ,a.rsqcostlimit as costlimit, a.rsqcostvalue as costvalue, b.rsqignorecostlimit as ignorecostlimit, b.rsqovercommit as overcommit from pg_resqueue_status a, pg_resqueue b where a.rsqname =b.rsqname order by 1;"'
alias rs='psql  -c " select rsqname, rsqcountlimit cntlimit, rsqcountvalue cntval, rsqcostlimit costlimit, rsqcostvalue vostval, rsqmemorylimit memlimit, rsqmemoryvalue memval, rsqwaiters waiters, rsqholders holders from gp_toolkit.gp_resqueue_status;"'
alias sp='source export/home/gpadmin/.bash_profile'
alias sq='psql -c " select * from pg_resqueue order by 1;"'
alias tq='psql -c " select count(*) from pg_stat_activity;"'
alias ts='psql -c "select n.nspname from pg_namespace n where nspname not in (select '\''pg_temp_'\''||sess_id from pg_stat_activity) and nspname  like '\''pg_temp%'\'';"'
alias rsh='psql -c " SELECT a.rsqname,a.rsqcountlimit,a.rsqcountvalue,a.rsqwaiters,a.rsqholders,a.rsqcostlimit,a.rsqcostvalue,a.rsqmemorylimit,a.rsqmemoryvalue,b.rsqignorecostlimit,b.rsqovercommit,c.ressetting FROM gp_toolkit.gp_resqueue_status a INNER JOIN pg_resqueue b ON b.rsqname = a.rsqname INNER JOIN pg_resqueue_attributes c ON c.rsqname = a.rsqname AND c.restypid = 5 ORDER BY 1;"'
alias reorg='psql -AXtc "select '\''ALTER TABLE '\''||bdinspname||'\''.'\''||bdirelname||'\'' SET WITH (REORGANIZE=TRUE); '\'' qry from gp_toolkit.gp_bloat_diag where bdirelpages*32/1024 > 10 ;" '
alias rs='psql  -c " select rsqname, rsqcountlimit cntlimit, rsqcountvalue cntval, rsqcostlimit costlimit, rsqcostvalue costval, rsqmemorylimit memlimit, rsqmemoryvalue memval, rsqwaiters waiters, rsqholders holders from gp_toolkit.gp_resqueue_status;"'
alias bt='psql -c "select bdinspname schema_nm, bdirelname tb_nm, bdirelpages*32.0/1024.0 real_size_mb, bdiexppages*32.0/1024.0 exp_size_mb from gp_toolkit.gp_bloat_diag where bdirelpages*32.0/1024.0 > 100;" '
alias qqit='psql  -c "SELECT substring(backend_start,1,19) as backend_tiem, now()-query_start as duration_time, usename, client_addr, waiting, procpid, sess_id, substring(current_query,1,20) FROM pg_stat_activity AS query_string WHERE current_query <> '\''<IDLE>'\'' ORDER BY waiting, duration_time desc;"'
alias mq='psql  -c "SELECT now()-query_start, usename, client_addr, waiting, procpid, sess_id FROM pg_stat_activity ORDER BY 1 DESC;"'
alias sq='psql  -c " select * from pg_resqueue order by 1;"'
alias rsh='psql -c " SELECT a.rsqname,a.rsqcountlimit,a.rsqcountvalue,a.rsqwaiters,a.rsqholders,a.rsqcostlimit,a.rsqcostvalue,a.rsqmemorylimit,a.rsqmemoryvalue,b.rsqignorecostlimit,b.rsqovercommit,c.ressetting FROM gp_toolkit.gp_resqueue_status a INNER JOIN pg_resqueue b ON b.rsqname = a.rsqname INNER JOIN pg_resqueue_attributes c ON c.rsqname = a.rsqname AND c.restypid = 5 ORDER BY 1;"'
alias wk='psql  -c " select * from workfile.gp_workfile_usage_per_segment where size > 1;"'
alias lt='psql  -c "SELECT distinct w.locktype, w.relation::regclass AS relation, w.mode, w.pid as waiting_pid, other.pid as running_pid FROM pg_catalog.pg_locks AS w JOIN pg_catalog.pg_stat_activity AS w_stm ON (w_stm.procpid = w.pid) JOIN pg_catalog.pg_locks AS other ON ((w.DATABASE = other.DATABASE AND w.relation = other.relation) OR w.transactionid = other.transactionid) JOIN pg_catalog.pg_stat_activity AS other_stm ON (other_stm.procpid = other.pid) WHERE NOT w.granted and w.pid <> other.pid;"'

